################
#      #   P   #
#      #       #
#      #       #
#      #       #
##D########D####
#              #
#              #
#              #
#              #
#              #
#              #
#              #
#              #
#              #
################